7, 7
1, 1
5, 5
-1, -1, -1, -1, -1, -1, -1
-1,  0, -1,  1,  1,  1, -1
-1,  1, -1,  1,  1,  1, -1
-1,  1,  1,  1,  1,  1, -1
-1,  1, -1,  1,  1,  1, -1
-1,  1,  1,  1, -1,  1, -1
-1, -1, -1, -1, -1, -1, -1